00000000000000000
00001111111110000
00110000000001100
01000000000000010
01000000000000010
10000000300000001
10011100000111001
10011100200111001
10011100100111001
01003001110030010
11010000000001011
10011111111111001
10001010101010001
01100111111100110
00011000000011000
00000111111100000
00000000000000000