11111111111111111
10000003000000001
10111111011111001
10100001010001001
10101111011111001
10000003000000001
10011101111001001
10010001000101001
10011101111001001
10100000300001001
10101111111111001
10000010001000001
10111110101111001
10100000100001001
10111111111111001
10000002000000001
11111111111111111