00000000000000000
00001111111110000
00110003000001100
01000000000000010
01000000020000010
10000003000000001
10011100000111001
10011100000111001
10011100100111001
