1111111111
1000000001
1013303331
1000110001
1000110001
1333110001
1010000101
1030020001
1300000031
1111111111