11111111111111111
14000300030000041
10111111111111001
10100000000041001
10101110111111001
14000000400000041
10111011101011001
10001400000001001
10001111111001001
10103004000001001
10101111101111001
10100041000300041
10111101101111001
10040003000040001
10111111111111001
14000002000000041
11111111111111111
