11111111111111111
13004000300040031
10111111011111001
10100001010001001
10101111011111001
10003000000030001
10011101111001001
10010001000101001
10011101111001001
10100300003001001
10101111111111001
10300010001000301
10111110101111001
10100000100001001
10111111111111001
10304002004000001
11111111111111111
