11111111111111111
13000000300000031
10000000400000001
10003003000030001
10000000003000001
10003000000030001
10000030300000001
10040003000040001
10030000300003001
10000300003000001
10400004000004001
10300030030000301
10003040000400001
10000003000003001
10030000020003001
10300004000030001
11111111111111111