1111111111
1430000341
1011101101
1010000101
1010110141
1403000301
1011101101
1010003101
1020400041
1111111111
