1111111111
1400000041
1031103101
1000000001
1011111101
1000400001
1010310101
1000400001
1020003101
1111111111
