11111111111111111
14003000400300041
10111111011111001
10100001010001001
10101111011111001
10004000400040001
13011101111001031
10010001000101001
10011101111001001
10100000000001001
10101111111111001
10300010001000301
10101110101101001
10140000100041001
10111111111111001
14000002000000041
11111111111111111