10001111111110001
10110004400001101
11003020300300011
11000400004000011
10003000400030001
10011100000111001
10011100000111001
10011130103111001
11000001110000011
11010000400001011
10011111111111001
10001010101010001
11100111111100111
10011000000011001
10000111111100001