10000000001
10100100001
10101110001
10010000000
10100100001
10000200001
11111111111