00000000000000000
00001111111110000
00110000000001100
01000000000000010
01000000020000010
10000000000000001
10011100000111001
10011100000111001
10011100100111001
