10000300001
10100100001
10101110001
10101110001
10100100001
10000200001
11111111111