11111111111
10100103001
10101110001
10010300001
10130100001
10000200001
11111111111