1100000011
1000300001
0010300100
0000110000
0030110000
0000110000
0010000100
0030020000
1000300001
1100000011