1103030011
1000300001
0010300100
3030113000
0300110300
0300110000
0010000130
0030023000
1030303001
1100300011